20:7 
20 0 59 0 0 0 64 0 0 16 32 20 0 0 82 82 84 84 0 0 
82 20 0 0 0 0 0 16 0 0 0 20 0 0 0 0 0 0 0 0 
96 34 20 0 0 0 0 0 0 0 0 0 0 0 0 0 0 0 0 0 
20 20 0 0 20 20 20 20 20 20 20 20 20 20 0 0 20 20 20 20 
83 0 20 64 20 0 0 0 0 0 0 37 0 0 0 0 0 0 0 0 
16 62 20 20 86 37 0 0 0 37 0 0 0 0 0 0 0 0 0 0 
35 0 0 0 0 0 0 0 16 16 16 16 16 16 16 16 16 16 16 0 

