12:12 
20 0 0 0 0 0 52 0 0 16 32 20 
82 20 0 0 0 0 0 0 0 0 0 0 
96 82 20 0 0 0 0 0 0 0 0 0 
0 96 82 20 0 0 0 0 0 0 0 0 
83 0 96 82 20 0 0 0 0 0 0 0 
16 81 0 0 86 37 0 0 0 0 0 0 
83 0 96 84 20 0 0 0 0 0 0 0 
0 96 84 20 0 0 0 0 0 0 0 0 
96 84 20 0 0 0 0 0 0 64 0 0 
84 20 0 0 0 0 0 0 0 0 0 0 
20 0 0 0 0 0 0 0 0 0 0 0 
0 0 49 0 0 0 0 0 0 0 0 0 
