12:12 
20 56 0 0 38 0 0 0 0 16 32 20 
82 20 0 0 0 0 0 0 0 0 0 0 
0 0 20 0 0 0 0 0 0 0 0 0 
64 96 0 20 0 0 0 0 38 0 0 0 
83 0 96 0 20 0 0 0 0 0 32 0 
16 81 0 0 0 37 0 0 0 0 0 0 
86 0 96 84 20 0 0 64 0 0 81 0 
36 96 84 20 0 0 0 0 0 0 0 0 
32 0 20 0 0 0 0 0 0 0 0 0 
32 20 38 0 0 0 0 0 0 64 0 0 
20 0 0 0 0 0 0 0 0 0 0 0 
53 0 34 0 0 0 0 0 0 0 0 64 
