12:12 
20 20 20 20 20 20 51 20 20 16 0 0 
0 0 0 0 16 16 66 67 70 16 0 0 
16 16 0 0 0 20 0 0 16 0 0 0 
0 0 0 0 0 0 0 0 20 0 0 0 
0 0 0 0 96 0 0 0 0 0 0 0 
16 20 16 0 0 0 0 20 20 0 0 0 
0 0 0 0 96 0 84 20 20 16 0 0 
20 20 0 0 20 20 64 0 0 16 0 0 
0 0 0 0 20 0 20 16 16 16 0 0 
20 20 0 0 0 16 0 0 20 20 0 0 
0 0 0 0 0 0 0 0 0 0 0 0 
54 0 0 0 0 0 0 0 37 0 0 0 
