12:12 
20 55 0 0 0 96 0 0 0 16 32 20 
82 20 0 0 0 0 0 0 0 0 0 0 
96 82 20 0 20 0 20 20 0 20 0 0 
0 96 0 20 0 0 0 0 0 0 0 0 
85 0 96 82 20 0 0 0 38 0 0 0 
16 81 0 0 86 37 0 0 0 0 0 64 
82 0 96 84 20 0 0 0 0 0 0 64 
0 96 0 0 0 0 0 0 0 0 0 0 
20 96 0 0 0 0 20 20 20 37 36 38 
20 0 0 0 0 0 20 0 0 0 0 0 
20 0 0 0 0 0 20 0 0 0 64 0 
0 64 0 0 0 0 20 0 58 0 0 0 
