12:12 
20 0 60 0 0 0 0 0 0 16 32 20 
82 20 0 0 0 20 0 85 0 0 32 32 
96 82 0 20 20 38 37 0 0 0 0 0 
64 96 82 0 0 0 0 0 0 0 0 20 
83 0 96 0 0 0 0 0 0 0 0 0 
16 81 0 0 86 37 0 0 85 36 32 32 
83 0 96 0 0 0 0 0 0 0 0 0 
64 96 0 0 0 0 0 0 0 0 0 0 
96 0 64 0 0 0 0 0 0 0 0 0 
20 0 0 0 0 0 34 33 37 0 0 0 
0 0 0 0 0 38 0 0 0 0 0 0 
64 0 0 0 0 0 0 0 57 0 0 0 
