12:12 
37 0 0 0 128 0 16 0 64 16 37 20 
0 0 0 0 38 0 0 0 0 20 0 0 
16 0 0 0 0 0 0 0 0 20 0 0 
0 0 0 16 0 16 0 0 0 96 0 82 
20 0 0 0 38 0 16 0 0 20 0 84 
0 0 0 16 16 16 0 0 20 20 0 84 
16 0 34 0 0 0 0 0 0 20 0 84 
0 0 33 0 37 0 0 0 20 20 0 20 
20 0 35 0 0 0 38 0 0 20 0 16 
0 0 0 0 0 0 0 0 0 20 0 0 
32 20 20 20 20 20 20 20 20 20 0 0 
83 86 50 0 0 0 0 20 20 0 0 0 
 
