12:12 
20 0 0 0 0 38 0 38 0 16 32 20 
82 0 0 0 0 0 0 0 0 0 0 0 
96 82 0 0 0 0 0 0 0 0 0 38 
0 36 82 0 0 0 0 0 0 0 0 0 
83 0 36 82 0 0 0 0 0 0 0 0 
16 61 0 0 36 37 0 0 0 0 0 0 
83 0 96 34 20 0 0 0 0 0 0 0 
0 96 83 20 0 20 0 0 0 0 0 0 
96 83 20 0 96 0 37 20 0 64 0 0  
83 20 0 96 0 0 0 0 0 20 0 0 
20 0 0 0 0 96 0 0 0 0 0 20 
0 0  0 146 0 0 0 0 0 0 0 20 
